*******************************************************************
*                                                                 *
*  *        *              *  *        *        *              *  *
*  *******  ****  ****  **********  *  *  *  *************  *  *  *
*                    *  *     *     *  *  *     *  *  *     *  *  *
* ***********  ****  *******  ****  **********  *  *  *******  *  *
*           *     *     *                       *     *  *     *  *
****  ****  *******  *  *  *******************  ****  *  *  ****  *
*     *     *  *     *  *     *              *                 *  *
*  *  *  *  *  ****  **** *****  *******  *  *  ****  ****  *  *  *
*  *  *  *                 *     *        *     *     *     *  *  *
* *****  *******  *******  *  *  * ****** *************  *  *  *  *
*  *  *  *        *     *     *  *      *       *        *  *  *  *
*  *  ****  ****  ****  *  *  *  *      * *  ****  *******  *  *  *
*                          *  *  *      * *                       *
* ********  *************  ****  *      * *******  *  **********  *
*                    *     *     *        *  *     *        *     *
*  ****  ****  *  ****  ****  *  ****  ****  *  **********  ****  *
*     *     *  *  *        *  *     *     *        *        *     *
*  **********  ****  *  *  *  ****  *  ***** *  **********  ***** *
*     *              ****  *     *  *        *  *  *  *     *     *
*  *******  *******  *  *  *******  *  ****  *  *  *  *  *******  *
*                 *           *              *                    *
*******************************************************************
